# Resources from graph.properties
alreadyConnected=Узлы уже связаны
cancel=Отмена
close=Закрыть
collapse-expand=Складывать
containsValidationErrors=Содержит Ошибки Проверки
done=Готово
doubleClickOrientation=Дважды щелкните, чтобы изменить ориентацию
error=Ошибка
errorSavingFile=Ошибка сохранения файла
ok=OK
updatingDocument=Обновить Документ. Пожалуйста, подождите...
updatingSelection=Обновите Маркер. Пожалуйста, подождите...
# Custom resources
about=О нас
actualSize=Фактический Размер
add=Добавить
addLayer=Вставить слой
addProperty=Вставить свойство
addToExistingDrawing=Вставить в существующий чертеж
addWaypoint=Вставить путевую точку
advanced=Распространенные
align=Выравнивание
alignment=Ориентация
allChangesLost=Все изменения будут потеряны!
angle=Угол
apply=Применять
arc=Дуга
arrange=Упорядочивать
arrow=Стрелка
arrows=Стрелки
automatic=Автоматически
autosave=Автоматическое Сохранение
autosize=Настройка размера
back=Назад
background=Фон
backgroundColor=Цвет фона
backgroundImage=Фоновое изображение
basic=Простой
block=Блок
blockquote=Цитата
bold=Жирный
border=Рамка
borderWidth=Ширина рамки
borderColor=Цвет рамки
bottom=Unten
bottomAlign=Unten
bottomLeft=Нижний левый
bottomRight=Нижний правый
bulletedList=Маркированный список
cannotOpenFile=Не удается открыть файл
center=Центер
change=Изменить
changeOrientation=Изменение ориентации
circle=Круг
classic=Классический
clearDefaultStyle=Удалить стиль по умолчанию
clearWaypoints=Удаление путевых точек
clipart=Иконки
collapse=Сложить
collapseExpand=Развернуть
collapsible=Складная
comic=Комик
connect=Перевязка
connection=Соединение
connectionPoints=Точка соединения
connectionArrows=Соединительные стрелки
constrainProportions=Сохранение пропорций
copy=Копировать
copyConnect=Beim Verbinden kopieren
copySize=Grösse kopieren
create=Erstellen
curved=Gebogen
custom=Benutzerdefiniert
cut=Ausschneiden
dashed=Gestrichelt
decreaseIndent=Einzug verringern
default=Vorgegeben
delete=Löschen
deleteColumn=Spalte löschen
deleteRow=Zeile löschen
diagram=Диаграмма
diamond=Алмаз
diamondThin=Diamant (Schmal)
direction=Richtung
distribute=Verteilen
divider=Treelinie
documentProperties=Dokumenteigenschaften
dotted=Punktiert
dpi=DPI
drawing=Drawing-{1}
drawingEmpty=Рисунок пуст
drawingTooLarge=Рисунок слишком велик
duplicate=Дублировать
duplicateIt={1} Дублировать
east=Восток
edit=Правка
editData=Редактирование метаданных
editDiagram=Редактирование диаграммы
editImage=Редактирование изображения
editLink=Изменить ссылку
editStyle=Изменить стиль
editTooltip=Редактировать всплывающую подсказку
enterGroup=Введите группу
enterValue=Введите значение
enterName=Введите имя
enterPropertyName=Eigenschaftsname eingeben
entityRelation=Entity Relation
exitGroup=Aus Gruppe heraus
expand=Ausklappen
export=Сохранить
extras=Дополнительно
file=Файл
fileNotFound=Файл не найден
filename=Имя файла
fill=Füllen
fillColor=Füllfarbe
fitPage=Ganze Seite
fitPageWidth=Seitenbreite
fitTwoPages=Zwei Seiten
fitWindow=An Fenstergrösse anpassen
flip=Spiegeln
flipH=Horizontal Spiegeln
flipV=Vertikal Spiegeln
font=Schrift
fontFamily=Schriftart
fontColor=Schriftfarbe
fontSize=Размер шрифта
format=Формат
formatPanel=Панель " Форматирование"
general=Общий
formatPdf=PDF
formatPng=PNG
formatGif=GIF
formatJpg=JPEG
formatSvg=SVG
formatXml=XML
formatted=Форматируете
formattedText=Отформатированный Текст
gap=Разрыв
glass=Стекло
general=Основные
global=Глобальный
gradient=Ход
gradientColor=Цвет
grid=Сетка
gridSize=Размер сетки
group=Группа
guides=Направляющие
heading=Заголовок
height=Высота
help=Помощь
hide=Скрыть
hideIt={1} скрыть
hidden=Скрытый
home=Дом
horizontal=Горизонтальный
horizontalFlow=Горизонтальный Поток
horizontalTree=Горизонтальное Дерево
html=HTML
id=ID
image=Изображение
images=Изображения
import=Импортировать
increaseIndent=Увеличить отступ
insert=Вставить
insertColumnBefore=Вставить столбец слева
insertColumnAfter=Вставить столбец справа
insertHorizontalRule=Вставить горизонтальную линию
insertImage=Вставить изображение
insertLink=Вставить ссылку
insertRowBefore=Вставить строку выше
insertRowAfter=Вставить строку ниже
invalidInput=Неверный Ввод
invalidName=Недопустимое Имя
invalidOrMissingFile=Недопустимый или отсутствующий файл
isometric=Изометрический
italic=Курсив
layers=Уровни
landscape=Альбомный
laneColor=Lane-Farbe
layout=Макет
left=Слева
leftAlign=Слева
leftToRight=Слева направо
line=Линия
lineJumps=Линейные прыжки
link=Ссылка
lineend=Конец линии
lineheight=Высота строки
linestart=Начало линии
linewidth=Ширина линии
loading=Загрузка
lockUnlock=Блокировка / Разблокировка
manual=Вручную
middle=Середина
misc=Разное
more=Еще
moreResults=Больше Результатов
move=Перемещать
moveSelectionTo=Вставить маркер в {1}
navigation=Навигация
new=Новый файл
noColor=Нет Цвета
noFiles=Нет Файлов
noMoreResults=Никаких Других Результатов
none=Без
noResultsFor=Нет результатов для ' {1}'
normal=Нормально
north=Север
numberedList=Пронумерованный Список
opacity=Кроющая способность
open=Открыть/Создать проект
openArrow=Открыть
openFile=Открыть файл
openLink=Открыть ссылку
openSupported=Поддерживаемые форматы создаются с помощью этого приложения .XML-файлы
openInNewWindow=Открыть в новом окне
openInThisWindow=Открыть в этом окне
options=Настройки
organic=Органический
orthogonal=Ортогональный
outline=Обзор
oval=Овал
pages=Страница
pageView=Просмотр страницы
pageScale=Увличить
pageSetup=Настройка страницы
panTooltip=Пробел+перетащите для прокрутки
paperSize=Размер страницы
paste=Вставить
pasteHere=Hier einfügen
pasteSize=Вставить размер
pattern=Muster
perimeter=Umfang
placeholders=Заполнители
plusTooltip=Нажмите для подключения и клонирования (нажмите и удерживайте клавишу Ctrl для клонирования, Shift+click для подключения). Перетаскивание для подключения (нажмите и удерживайте клавишу Ctrl для клонирования).
portrait=Вертикальный
position=Позиция
posterPrint=Печать плаката
preview=Предварительный просмотр
print=Печать
radialTree=Радиальное Дерево
redo=Восстановить
removeFormat=Удалить форматирование
removeFromGroup=Удалить из группы
removeIt={1} удалить
removeWaypoint=Удалить путевую точку
rename=Переименовать
renameIt={1} переименовать
replace=Замена
replaceIt={1} уже существует. Перезаписать файл?
replaceExistingDrawing=Замена существующего чертежа
reset=Сдавать
resetView=Сброс вида
reverse=Перевернуть
right=Право
rightAlign=Правее
rightToLeft=Справа налево
rotate=Rotieren
rotateTooltip=Нажмите и перетащите, чтобы вращаться, нажмите, чтобы повернуть только форму на 90 градусов
rotation=Вращение
rounded=Закругленный
save=Сохранить
saveAs=Сохранить как
saved=Сохранено
scrollbars=Полосы прокрутки
search=Поиск
searchShapes=Поиск по формам
selectAll=Выбрать все
selectEdges=Отметить кромки
selectFont=Выбрать шрифт
selectNone=Снять отметку
selectVertices=Выделить узлы
setAsDefaultStyle=Установить в качестве стиля по умолчанию
shadow=Тень
shape=Форма
sharp=Квадрат
sidebarTooltip=Нажмите, чтобы развернуть. Перетаскивание объектов на диаграмму. Shift + нажмите, чтобы изменить маркер. Alt + нажмите для вставки и подключения.
simple=Простой
simpleArrow=Простая Стрелка
size=Размер
solid=Жирный
sourceSpacing=Начальное расстояние
south=Юг
spacing=Расстояние
straight=Прямой
strikethrough=Зачеркнутый
strokeColor=Цвет линии
style=Стиль
subscript=Низменный
superscript=Высокопоставленный
table=Таблица
targetSpacing=Endabstand
text=Текст
textAlignment=Выравнивание Текста
textOpacity=Непрозрачность Текста
toBack=Назад
toFront=Вперед
tooltips=Всплывающие подсказки
top=Сверху
topLeft=Сверху лево
topRight=Сверху право
topAlign=Сверху
transparent=Прозрачный
turn=Поворот формы на 90°
uml=UML
underline=Подчеркивали
undo=Аннулировать
ungroup=Отменить группировку
untitledLayer=Безымянный Уровень
url=URL
vertical=Вертикал
verticalFlow=Вертикальный Поток
verticalTree=Вертикальное Дерево
view=Просмотр
waypoints=Путевые точки
west=Запад
width=Ширина
wordWrap=Авт. Перенос строк
writingDirection=Направление текста
zoom=Размер
zoomIn=Увеличить
zoomOut=Уменьшить
